IPAddress - класс
 
Предоставляет IP-адрес. Класс IPAddress содержит адрес компьютера в IP-сети.

Пространство имен:   System.Net
Сборка:  System (в System.dll)

Иерархия наследования
System.Object
System.Net.IPAddress

Синтаксис
[SerializableAttribute]
public class IPAddress

Конструкторы
 IPAddress(Byte[])	Инициализирует новый экземпляр класса IPAddress с указанным адресом, заданным в виде массива Byte.
 IPAddress(Byte[], Int64)	Инициализирует новый экземпляр класса IPAddress с адресом, указанным в виде массива Byte, и указанным идентификатором области.
 IPAddress(Int64)	Инициализирует новый экземпляр класса IPAddress с указанным адресом, заданным в виде массива Int64.

Свойства
 Address	Устарело.IP-адрес.
 AddressFamily	Возвращает семейство адресов для IP-адреса.
 IsIPv4MappedToIPv6	Возвращает сведения о том, является ли IP-адрес адресом IPv6, сопоставленным с IPv4.
 IsIPv6LinkLocal	Возвращает сведения о том, является ли адрес локальным IPv6-адресом для канала связи.
 IsIPv6Multicast	Возвращает сведения о том, является ли IPv6-адрес многоадресным глобальным адресом.
 IsIPv6SiteLocal	Возвращает сведения о том, является ли адрес локальным IPv6-адресом для веб-узла.
 IsIPv6Teredo	Получает сведения о том, является ли адрес IPv6-адресом Teredo.
 ScopeId	Возвращает или задает идентификатор области действия адреса, соответствующего протоколу IPv6.

Методы
 Equals(Object)	Сравнивает два IP-адреса.(Переопределяет Object.Equals(Object).)
 Finalize()	Позволяет объекту попытаться освободить ресурсы и выполнить другие операции по очистке перед тем, как объект будет утилизирован сборщиком мусора. (Наследуется от Object.)
 GetAddressBytes()	Предоставляет копию IPAddress в виде массива байтов.
 GetHashCode()	Возвращает значение хэш-функции для IP-адреса.(Переопределяет Object.GetHashCode().)
 GetType()	Возвращает объект класса Type для текущего экземпляра. (Наследуется от Object.)
 HostToNetworkOrder(Int16)	Преобразует короткое значение из байтового формата узла в сетевой байтовый формат.
 HostToNetworkOrder(Int32)	Преобразует целое значение из байтового формата узла в сетевой байтовый формат.
 HostToNetworkOrder(Int64)	Преобразует длинное целое значение из байтового формата узла в сетевой байтовый формат.
 IsLoopback(IPAddress)	Показывает, является ли IP-адрес адресом замыкания на себя.
 MapToIPv4()	Сопоставляет объект IPAddress с адресом IPv4.
 MapToIPv6()	Сопоставляет объект IPAddress с адресом IPv6.
 MemberwiseClone()	Создает "поверхностную" копию текущего объекта. (Наследуется от Object.)
 NetworkToHostOrder(Int16)	Преобразует короткое значение из байтового формата узла в сетевой байтовый формат.
 NetworkToHostOrder(Int32)	Преобразует целое значение из байтового формата узла в сетевой байтовый формат.
 NetworkToHostOrder(Int64)	Преобразует длинное целое значение из байтового формата узла в сетевой байтовый формат.
 Parse(String)	Преобразует строку IP-адреса в экземпляр класса IPAddress.
 ToString()	Преобразует адрес в Интернете в его стандартный формат.(Переопределяет Object.ToString().)
 TryParse(String, IPAddress)	Определяет, является ли строка допустимым IP-адресом.

Поля
 Any	Предоставляет IP-адрес, указывающий, что сервер должен контролировать действия клиентов на всех сетевых интерфейсах.Это поле доступно только для чтения.
 Broadcast	Предоставляет широковещательный IP-адрес.Это поле доступно только для чтения.
 IPv6Any	Метод Socket.Bind использует поле IPv6Any для указания того, что экземпляр класса Socket должен контролировать действия клиентов на всех сетевых интерфейсах.
 IPv6Loopback	Предоставляет IP-адрес замыкания на себя.Это свойство доступно только для чтения.
 IPv6None	Предоставляет IP-адрес, указывающий, что сетевой интерфейс не должен использоваться.Это свойство доступно только для чтения.
 Loopback	Предоставляет IP-адрес замыкания на себя.Это поле доступно только для чтения.
 None	Предоставляет IP-адрес, указывающий, что сетевой интерфейс не должен использоваться.Это поле доступно только для чтения.