WebRequest - класс
 
Выполняет запрос к универсальному коду ресурса (URI). Этот класс является абстрактным.

Пространство имен:   System.Net
Сборка:  System (в System.dll)

Иерархия наследования
System.Object
System.MarshalByRefObject
System.Net.WebRequest
System.IO.Packaging.PackWebRequest
System.Net.FileWebRequest
System.Net.FtpWebRequest
System.Net.HttpWebRequest

Синтаксис
[SerializableAttribute]
public abstract class WebRequest : MarshalByRefObject, ISerializable

Конструкторы
 WebRequest()	Инициализирует новый экземпляр класса WebRequest.
 WebRequest(SerializationInfo, StreamingContext)	Инициализирует новый экземпляр класса WebRequest на основе указанных экземпляров классов SerializationInfo и StreamingContext.

Свойства
 AuthenticationLevel	Возвращает или задает значения, указывающие уровень проверки подлинности и олицетворения, используемые для этого запроса.
 CachePolicy	Возвращает или задает политику кэширования для этого запроса.
 ConnectionGroupName	Если переопределено во вложенном классе, возвращает или задает имя группы подключения для данного запроса.
 ContentLength	Если переопределено во вложенном классе, возвращает или задает длину содержимого запрошенных к передаче данных.
 ContentType	При переопределении во вложенном классе возвращает или задает тип содержимого запрошенных к передаче данных.
 CreatorInstance	Устарело.Если переопределено в производном классе, получает объект фабрики, производный от класса IWebRequestCreate, который служит для создания объекта WebRequest для создания запроса по указанному универсальному коду ресурса (URI).
 Credentials	Если переопределено во вложенном классе, возвращает или задает сетевые учетные данные, используемые для проверки подлинности запроса на интернет-ресурсе.
 DefaultCachePolicy	Возвращает или задает политику кэширования для этого запроса.
 DefaultWebProxy	Возвращает или устанавливает глобальный прокси-сервер HTTP.
 Headers	Если переопределено во вложенном классе, возвращает или задает коллекцию связанных с данным запросом пар "имя — значение" для заголовка.
 ImpersonationLevel	Возвращает или задает уровень олицетворения для текущего запроса.
 Method	Если переопределено во вложенном классе, возвращает или задает метод протокола для использования в данном запросе.
 PreAuthenticate	Если переопределено во вложенном классе, показывает, необходима ли предварительная проверка подлинности данного запроса.
 Proxy	Если переопределено во вложенном классе, возвращает или задает сетевой прокси-сервер, используемый для доступа к данному интернет-ресурсу.
 RequestUri	Если переопределено во вложенном классе, возвращает URI интернет-ресурса, связанного с данным запросом.
 Timeout	Возвращает или задает промежуток времени в миллисекундах до истечения срока действия запроса.
 UseDefaultCredentials	Если переопределено во вложенном классе, возвращает или задает значение Boolean, с помощью которого определяется, следует ли отправлять учетные данные DefaultCredentials вместе с запросами.

Методы
 Abort()	Отменяет запрос
 BeginGetRequestStream(AsyncCallback, Object)	Если переопределено во вложенном классе, предоставляет асинхронную версию метода GetRequestStream.
 BeginGetResponse(AsyncCallback, Object)	Если переопределено во вложенном классе, начинает асинхронный запрос интернет-ресурса.
System_CAPS_pubmethodSystem_CAPS_static	Create(String)	Инициализирует новый экземпляр WebRequest для заданной схемы URI.
System_CAPS_pubmethodSystem_CAPS_static	Create(Uri)	Инициализирует новый экземпляр WebRequest для заданной схемы URI.
System_CAPS_pubmethodSystem_CAPS_static	CreateDefault(Uri)	Инициализирует новый экземпляр WebRequest для заданной схемы URI.
System_CAPS_pubmethodSystem_CAPS_static	CreateHttp(String)	Инициализирует новый экземпляр HttpWebRequest для заданной строки URI.
System_CAPS_pubmethodSystem_CAPS_static	CreateHttp(Uri)	Инициализирует новый экземпляр HttpWebRequest для заданного URI.
 CreateObjRef(Type)	Создает объект, который содержит всю необходимую информацию для создания прокси-сервера, используемого для взаимодействия с удаленным объектом.(Наследуется от MarshalByRefObject.)
 EndGetRequestStream(IAsyncResult)	Если переопределено в производном классе, возвращает Stream для записи данных в этот интернет-ресурс.
 EndGetResponse(IAsyncResult)	Если переопределено в производном классе, возвращает WebResponse.
 Equals(Object)	Определяет, равен ли заданный объект текущему объекту.(Наследуется от Object.)
 Finalize()	Позволяет объекту попытаться освободить ресурсы и выполнить другие операции по очистке перед тем, как объект будет утилизирован сборщиком мусора. (Наследуется от Object.)
 GetHashCode()	Играет роль хэш-функции для определённого типа.(Наследуется от Object.)
 GetLifetimeService()	Извлекает объект обслуживания во время существования, который управляет политикой времени существования данного экземпляра.(Наследуется от MarshalByRefObject.)
 GetObjectData(SerializationInfo, StreamingContext)	Этот API служит для поддержки инфраструктуры продукт и не предназначен для непосредственного использования из кода. Заполняет объект SerializationInfo данными, необходимыми для сериализации целевого объекта.
 GetRequestStream()	Если переопределено в производном классе, возвращает Stream для записи данных в этот интернет-ресурс.
 GetRequestStreamAsync()	Если переопределено во вложенном классе, возвращает Stream для записи данных в интернет-ресурс в ходе асинхронной операции.
 GetResponse()	Если переопределено во вложенном классе, возвращает ответ на интернет-запрос.
 GetResponseAsync()	Если переопределено во вложенном классе, возвращает ответ на интернет-запрос в ходе асинхронной операции.
 GetSystemWebProxy()	Возвращает прокси-сервер с уже установленными параметрами Internet Explorer для текущего олицетворенного пользователя.
 GetType()	Возвращает объект класса Type для текущего экземпляра. (Наследуется от Object.)
 InitializeLifetimeService()	Возвращает объект обслуживания во время существования для управления политикой времени существования данного экземпляра.(Наследуется от MarshalByRefObject.)
 MemberwiseClone()	Создает "поверхностную" копию текущего объекта. (Наследуется от Object.)
 MemberwiseClone(Boolean)	Создает неполную копию текущего объекта MarshalByRefObject.(Наследуется от MarshalByRefObject.)
 RegisterPortableWebRequestCreator(IWebRequestCreate)	Устарело.Регистрация объекта IWebRequestCreate.
 RegisterPrefix(String, IWebRequestCreate)	Регистрирует потомок WebRequest для заданной схемы URI.
 ToString()	Возвращает строковое представление текущего объекта.(Наследуется от Object.)

Явные реализации интерфейса
 ISerializable.GetObjectData(SerializationInfo, StreamingContext)	Этот API служит для поддержки инфраструктуры продукт и не предназначен для непосредственного использования из кода. Если переопределено во вложенном классе, заполняет экземпляр SerializationInfo данными, которые необходимы для сериализации WebRequest.